13 31
###############################
#p  x  ** *   3 *   *  * * *  #
# # # #*# # #*#*# # # #*#*#*# #
# 2 s     ***  *      *   * * #
# # # # # #*# # #*#*# # # # #*#
#f       2   **  *  *         #
# # # # # # # # # #*# #*# # # #
#*  *      *  *      *        #
# # # # #*# # # #*#*# # # # # #
#*    ** 1*       *           #
# #*# # # # # # #*# # # # # # #
#           *   *  *          #
###############################