13 31
###############################
#p     ** *  2  * 1 *  * * *  #
# # # #*# # #*#*# # # #*#*#*# #
#   s     ***  *      *   * * #
# # # # # #*# # #*#*# # # # #*#
#f         x **  *  *   1     #
# # # # # # # # # #*# #*# # # #
#*  *   1  *  *      *   4    #
# # # # #*# # # #*#*# # # # # #
#*    **  *    3  *           #
# #*# # # # # # #*# # # # # # #
#      4    *   *  *    3     #
###############################