13 31
###############################
#p   5 ** *  2  *   *  * * *  #
# # # #*# # #*#*# # # #*#*#*# #
#   s     ***  *      *   * * #
# # # # # #*# # #*#*# # # # #*#
#f         x **  *  *         #
# # # # # # # # # #*# #*# # # #
#*  *   1  *  *      *   4    #
# # # # #*# # # #*#*# # # # # #
#*    **  *    3  *           #
# #*# # # # # # #*# # # # # # #
#    5      *   *  *          #
###############################