13 31
###############################
#p     ** *  2  *   *  * * *  #
# # # #*# # #*#*# # # #*#*#*# #
#   s     ***  *      *   * * #
# # # # # #*# # #*#*# # # # #*#
#f         x **  *  *         #
# # # # # # # # # #*# #*# # # #
#*  *   1  *  *      *   4    #
# # # # #*# # # #*#*# # # # # #
#*    **  *    3  *           #
# #*# # # # # # #*# # # # # # #
#           *   *  *          #
###############################