13 31
###############################
#  px  ** *     *   *  * * *  #
# # # #*# # #*#*# # # #*#*#*# #
#4  s     ***  *      *   * * #
# # # # # #*# # #*#*# # # # #*#
#f     5     **  *  *         #
# # # # # # # # # #*# #*# # # #
#*  *      *  *      *        #
# # # # #*# # # #*#*# # # # # #
#*  6 **  *       *           #
# #*# # # # # # #*# # # # # # #
#           *   *  *          #
###############################