13 31
###############################
##    #*** ***b#  # **        #
##* * s #  *#*   ##*     ##   #
## p * * ##* ## # #*       * ##
#   #      *##  #5  *#****    #
#   #     6 #  *  * * *    #*##
### ### *  *   *     *#1 *   *#
# * *# #    *## ####*        ##
#*   x #   * *#  ##  #*   ## ##
#  *#         *#  *      **####
#*#   ### #*  * *#   # ***  #*#
###   f   #   # * **      #*  #
###############################
