13 31
###############################
# ** 5##*#  #   # # * x   f ###
#** *     *   4   ##   *   #  #
#   ##* ##  #*#* ##  *      #*#
#  #  ** *  ###*# #  *# #   # #
# #   # #*#* *#         ** #  #
#***    ## * ##*     1 *      #
#   *  ***    *#  # #   ## ####
#        *# #*  #   #    * 1 ##
#*  #*    * # 2 **#*# *   *   #
#*   *#  *#  # **# #*  #p *  ##
#  #   #   s**b *    * *# # * #
###############################
