13 31
###############################
#    **  *    #   1 *  **# *# #
###          **  *  # *    *  #
#####*#   ## #  * #*  *       #
## * #*#   ###  #*  #*#    ## #
##   **      *    *#   * ###6 #
##  #  # #p    *  ##  #** #*  #
#  *#   *  *#  #        # ### #
#  #1    #* *   # # 4#* *# *  #
## #  *     # *fx      *   *# #
##*# s*       ***#  *#  * *  *#
#     **#b   2#  **   #*  ##* #
###############################
